2
########
#..@..@#
#A..a..#
#..a#@.#
#@.a#..#
#.b..B.#
########
