-1
 #########################################
##..............#
#.@aA...........#
#.@a............#
#.@b............##########################
#.@bB....................................#
#.@c.....................................#
#.@cC....................................#
#.@d.....................................#
#.@d.....................................#
#.@dD....................................#
#.@d....................................#
#########################################
#########################################
#########################################
#########################################
#########################################
#########################################
#########################################
#########################################
#########################################
#########################################
#########################################
